111111111111111111
10000000000E010011
100000000000010011
100000000000010011
100000000000010011
100000000000010011
1PC000000C11111111
111111111111111111
