111111111111111111111111111
100000000100000000000000001
100000001000000000000000001
10CCCCC1CC11111111111111111
10111110100000C000000000001
10000100000000P000000000001
100010000E00000000000000001
100101000000000000000000001
100000000000000000000000001
111111111111111111111111111
